
:map 1 
:tags tradermall  
:scriptA checkout 
:scriptB revcheckout 
:scriptC trademallwindow 
:scriptD regiondef{ traderinside } 
:scriptE regiondef{ trader-weapon-buyer-inside } 
:size 54 18 
:off 1 0 
:tiles 
000000000004000000000000000000000000000000000000000000
222222222222222000000000000000000000000000000000000000
233333353333332222222222222222222222222222222222222000
211111151111112553555352553553552555555532335555552000
211D111511D1112551555152551551552555555512115555552000
211111151111112111111112111111112111111112111111112000
211111151111112111111112111111112111111112111111112000
21515111111111211D111B121A111D11211D111A121B111D112000
215151111111112111111112111111112111111112111111112000
211111151111B12111111112111111112111111112111111112000
211111151111112222221222221222222222221222221122222222
211D11151111112333331333331333333333331333331133333332
21111115111111311C11111111111C11111C111111111111C11112
21111115111111111111111111111111E111111111111111111112
211111111111112111111111111111111111111111111111111112
222222222222222111111111111111111111111111111111111112
333333333333332222222222222222222222222222222222222222
000000000000003333333333333333333333333333333333333333